GCG	GTG
ACG	ATG
CCG	CTG
TCG	TTG
CGC	CTC
AGC	ATC
TGT	TTT
TGC	TTC
GGC	GTC
CGT	CTT
GGT	GTT
AGT	ATT
TGA	TTA
AGA	ATA
GGA	GTA
TGG	TTG
CGA	CTA
CGG	CTG
AGG	ATG
GCT	GTT
GGG	GTG
CGC	CAC
